60
265,5  330,5
200,40  265,40  330,40  395,40
135,75  200,75  265,75  330,75  395,75  460,75
70,110  135,110  200,110  265,110  330,110  395,110  460,110  525,110
5,145  70,145  135,145  200,145  265,145  330,145  395,145  460,145  525,145  590,145
5,180  70,180  135,180  200,180  265,180  330,180  395,180  460,180  525,180  590,180
70,215  135,215  200,215  265,215  330,215  395,215  460,215  525,215
135,250  200,250  265,250  330,250  395,250  460,250
200,285  265,285  330,285  395,285
265,320  330,320
10
2, 5, 12, 19, 23, 26, 33, 36, 40, 47, 54, 57,