60
5,5  70,5  135,5  200,5  265,5  330,5  395,5  460,5  525,5  590,5
5,40  70,40  135,40  200,40  265,40  330,40  395,40  460,40  525,40  590,40
5,75  70,75  135,75  200,75  395,75  460,75  525,75  590,75
5,110  70,110  135,110  200,110  395,110  460,110  525,110  590,110
5,145  70,145  135,145  460,145  525,145  590,145
5,180  70,180  135,180  460,180  525,180  590,180
5,215  70,215  525,215  590,215
5,250  70,250  525,250  590,250
5,285  590,285
5,320  590,320
6
14, 15, 44, 45, 53, 54, 58, 59,