42
135,5  200,5  395,5  460,5
135,40  200,40  395,40  460,40
135,75  200,75  395,75  460,75
135,110  200,110  395,110  460,110
5,180  590,180
5,215  70,215  525,215  590,215
5,250  70,250  135,250  460,250  525,250  590,250
70,285  135,285  200,285  265,285  330,285  395,285  460,285  525,285
135,320  200,320  265,320  330,320  395,320  460,320
8
12, 13, 14, 15, 22, 27, 29, 32,