50
5,40  70,40  135,40  200,40  265,40  330,40  395,40  460,40  525,40  590,40
5,110  70,110  135,110  200,110  265,110  330,110  395,110  460,110  525,110  590,110
5,180  70,180  135,180  200,180  265,180  330,180  395,180  460,180  525,180  590,180
5,250  70,250  135,250  200,250  265,250  330,250  395,250  460,250  525,250  590,250
5,320  70,320  135,320  200,320  265,320  330,320  395,320  460,320  525,320  590,320
6
2, 7, 22, 27, 42, 47,