44
5,5  70,5  135,5  200,5  395,5  460,5  525,5  590,5
5,40  70,40  135,40  460,40  525,40  590,40
5,75  70,75  525,75  590,75
5,110  590,110
5,145  590,145
5,180  590,180
5,215  590,215
5,250  70,250  525,250  590,250
5,285  70,285  135,285  460,285  525,285  590,285
5,320  70,320  135,320  200,320  395,320  460,320  525,320  590,320
12
3, 4, 15, 16, 20, 21, 22, 23, 27, 28, 39, 40,