100
5,5  70,5  135,5  200,5  265,5  330,5  395,5  460,5  525,5  590,5
5,40  70,40  135,40  200,40  265,40  330,40  395,40  460,40  525,40  590,40
5,75  70,75  135,75  200,75  265,75  330,75  395,75  460,75  525,75  590,75
5,110  70,110  135,110  200,110  265,110  330,110  395,110  460,110  525,110  590,110
5,145  70,145  135,145  200,145  265,145  330,145  395,145  460,145  525,145  590,145
5,180  70,180  135,180  200,180  265,180  330,180  395,180  460,180  525,180  590,180
5,215  70,215  135,215  200,215  265,215  330,215  395,215  460,215  525,215  590,215
5,250  70,250  135,250  200,250  265,250  330,250  395,250  460,250  525,250  590,250
5,285  70,285  135,285  200,285  265,285  330,285  395,285  460,285  525,285  590,285
5,320  70,320  135,320  200,320  265,320  330,320  395,320  460,320  525,320  590,320
10
2, 7, 22, 27, 42, 47, 62, 67, 82, 87,